15,12,,,,,,,,,,,,,
1,0,0,0,0,0,0,0,0,0,0,0,0,0,1
1,0,0,0,0,0,0,0,0,0,0,0,0,0,1
1,0,0,0,0,0,0,0,0,0,0,0,0,0,1
1,0,0,0,0,0,0,0,0,0,0,0,0,0,1
1,0,0,0,0,0,0,0,0,0,0,0,0,0,1
1,0,0,0,0,0,0,0,0,0,0,0,0,0,1
1,0,0,0,0,0,0,0,0,0,0,0,0,0,1
1,0,0,0,0,0,0,0,0,0,0,0,0,0,1
1,12,0,0,0,0,0,0,0,0,0,0,0,13,1
1,1,1,1,1,1,1,1,1,5,14,4,1,1,1
1,1,1,1,1,1,1,1,1,10,0,11,1,1,1
1,1,1,1,1,1,1,1,1,18,18,18,1,1,1
