19,12,,,,,,,,,,,,,,,,,
1,1,1,1,1,1,1,1,1,1,1,1,1,1,1,1,1,1,1
1,10,0,0,0,0,0,0,0,0,0,0,0,0,0,0,0,1,1
1,0,0,0,0,0,0,0,0,0,0,0,0,0,0,0,0,1,1
1,12,0,0,0,0,0,0,0,0,0,0,0,0,0,0,0,1,1
1,1,1,1,1,1,1,1,1,1,1,5,14,14,1,3,0,1,1
1,10,0,0,0,0,0,0,0,0,0,0,0,0,1,1,0,1,1
1,0,0,0,0,0,0,0,0,0,0,0,0,0,1,1,0,1,1
1,0,0,0,0,0,0,0,0,0,0,0,0,0,1,1,0,1,1
1,12,0,0,0,0,0,0,0,0,0,0,0,0,1,1,0,1,1
1,1,1,1,1,1,1,1,1,1,1,1,14,14,1,1,18,1,1
1,1,1,1,1,1,1,1,1,1,1,1,23,23,1,1,18,1,1
1,1,1,1,1,1,1,1,1,1,1,1,1,1,1,1,18,1,1
